++++++++++++++++++++++
+      ++ ++         1
+    +      + ++++++++
+ +  + ++   + +++++ ++
+ +++++ +++   +      +
+          ++++ +  + +
+++++ + +       +  + +
+++++ +++  + +  ++   +
+          + + S+ ++ +
+++++ +  + + +       +
++++++++++++++++++++++